################~~~~~~~~~~~~##########################################^^^^^^^^^^^^^^^^^^^^^^^^^^^^^^^^^^^^^^
#```````````#~~~~~~~~~~~~~~~`````````````````````^^^^##```````````````^^^^^^^^^^^^```````````````````^^^^^^^
#```````````#``~~~~~~~~~~~```````^^^^^^^^````````````##````````§```````^^^^^^`````````````````````````````^^
#`````§`````#``````````````````^^^^```````````#########````````````````^^^^^^``````````````````````````````^
#```````````#```````````````^^^^^^``````````````#######````````````````^^``^^``````````````````````````````^
#```````````#`````````````````######````#############```````````````````^^^``^````````````````````````````^^
###`#########``````````````````###```````````````##``````````````````````^^^^^^````````````````````````^^^^^
#`````~~```````````````~~~~~~~~~~`````````````````````````````````````````^^^^^^``````````````````````^^^^^^
#````~~~~``````~~~~~~~~~~~~~~~~~~~`````````````````````````````````````````^^^^^^^^^^^^^^^``````^^^```^^^^^^
#``````````````~~~~~~~~~~~~~~~~~~~``````````````^^^^`````````````````````````^^^^^^^^^^^^^^^^^^^^^^```^^^^^^
#``````````````~~~~~~~~~~~~~~~~~~~```````````^^^^^^^^^#```````````````````````````^^^^^^^^^^^^^^^`````^^^^^^
#```````````````````````````########~~~~~~~~~~~~~~~^^^###``````````````````````````````^^^^^^^^^^``````````#
#`````````````````````````````````^^^^~~~~~~~~~~~~~~~######````````````````````````````^^^^^^^^````````````#
#````````````````^^^^``````````````^^^^^^^^^^^^~~~~~~~~~~####````````````````````````^^^^^^^^^^^^^`````````#
##########````^^^^^^^^^^````````````^^^^^^^~~~~~~~~~~~~~~~~##`````````````````````````^^^^^^^^^````````````#
###``````#######^^^^^^^^^^^`````````^^^^^^`````~~~~~~~~~~``````````````````````````````````````````````````#
#```````````````````````^^^^^^^```^^^^^^^^^^^^^^~~~~~~~````````````````````````````````````````````````````#
#```````````````````````````````````````###############```````````````^^^^````````````````````````````````##
#####``#####``^^`````````````````````######```````#####`````````````^^^^^^^^`````````````````````````§````##
##````````###^^^````````````~~~~```````````````````#####`````````^^^^^^^^^^^^^````````````````````````````##
#```````````##^^^`````````~~~~~~~`````````````§``````###``````^^^^^^^^^^^^^^````````^^^^^^``````````````####
#````````````^^^^``````````~~~~`````````###`````````######``````^^^^^^^^^`````````````^^^^^^`````````#######
######`````^^^^^^`````````````````````###`````````##########```````````````````^^^^^^^^^^^^^^`````##########
#########^^^^^^^^^^############################################^^^^^^^^^^^^^^^^^^^^^^^^^^^^^^^############## 